C 225,30,0
NO ./hey.xpm


 SO ./hey.xpm


     EA ./hey.xpm


F  210,100,0

   WE                ./hey.xpm




        1111111111111111111111111
        1000000000110000000000001
        101100000111000000000W001
        1010000000000000000000001
111111111011000001110000000000001
100000000011000001110111111111111
11110111111111011100000010001
11000111  111101 101010010001
1100000111010101 100000010001
10000000000000001100000010001
10000000000000000001010010001
11000001110101011111011110001
11110111 1110101 101111010001
11111111 1111111 111111111111

