C 225,30,0
NO ./path_to_the_north_texture


 SO ./path_to_the_south_texture


     EA ./path_to_the_east_texture


F  210,100,0

   WE                ./path_to_the_west_texture




        1111111111111111111111111
        1000000000110000000000001
        1011000001110000000000001
        1010000000000000000000001
111111111011000001110000000000001
100000000011000001110111111111111
11110111111111011100000010001
11000111  111101 101010010001
1100000111010101 100000010001
10000000000000001100000010001
1000N000000000000001010010001
1100000111010101111101111000111
11110111 1110101 101111010001
11111111 1111111 111111111111

